..#..##.##
..#..##...
....##....
..........
##..##.P..
.#..##....
...##.#.#.
..........
...##...#.
#...##....