.##.....#.
.....#....
#..#####..
...#......
.....P.#..
...#...#..
...#..##..
.........#
.##.....#.
.....#....