###......#
##..#....#
#......#..
.#.......#
...#......
##.....#..
#..##.##..
...#...#..
#....P...#
###.....##